                 #...,,,(.                          #,%##/.,#         
                #.%#&,,,,.#                        ./,%##&,.#         
               ./%###&,..../(                      ,*/###&,.(.        
               .%%#####(...,,&                     //(###%*.(,        
     .,,,,,,    *&######&*,,,,*#                   ,(*%###/,(,        
     .,,,,,,      (&######&.,,,,((                  %,&####,#.        
     .,,,,,.         %&#####&,.,,.#*                /*(###%.#         
     ,,,,,.              (&%##&(..,.##               %.&###,%         
     ,,,,,                    /&&%,,,,,%#(((///////##(%,&#%.%         
     .,,,                    ./#/,,.,/(,,.*,.,,,,,,,,/#%.#%,%,.       
                          ./#(///////////((////(##%&%(*,*,..&%//(/    
      ,,                ,(////////////////////////////////%&(,,*%//#. 
                  ,#&#(#/********//////*********///////////////%#,%(((
                %,,,,#//////////////////****/***//////*********///&#((
                #/(*##///////////(#(%(///////////##//(/////****////(((
            %,.((//##(//////////#*#(////////////(/#//////(//////////%%
           ,#(////#/#((((((((((#..((#(((((((((((#.#(((//(#/////////(@,
            #///////&#///(&#*.......,/(#.......*/(/(*,,*#(///////(&(..
           ,(/////%@&#////&    ,%&&%&(            **,   #(%(////&*,,,.
           .(////&&&%(///#(  &#######%/       .&/(####%&#////////#&&%(
            (///@&&&%////(,..&##((###&        /%#######%(//////(@&@%//
            ///(&&&&#///(,,,,.....              (@@@&&*#//////&&@&%(//
            .(/////((///%(.......       %(%     ....*.*(*////#@&&&%///
            .(****/((////(((((#(,.              .....,*#/////(((#.(///
            (((*///((#///((((.       #...... ...  ./( (/#///((((( ,(//
     ,(##(//#///////##///((((.     &.#,.(&&&&....%...##((///(((#   #//
  .#////////////////((#//((((.   .%...,(@@@@@(/(......(%///((#(    ///
   *#///////////////((((#*(##.  /(. %@&&&&#&&&&&@( ....##(.        .#/