1222222222222222222222222222222222222222222222222222222222222222222223
4000000000000000000000000000000000000000000000000000000000000000000004
4000000000000000000000000000000000000000000000000000000000000000000004
4000000000000000000000000000000000000000000000000000000000000000000004
4000000000000000000000000000000000000000000000000000000000000000000004
4000000000000000000000000000000000000000000000000000000000000000000004
4000000000000000000000000000000000000000000000000000000000000000000004
4000000000000000000000000000000000000000000000000000000000000000000004
4000000000000000000000000000000000000000000000000000000000000000000004
4000000000000000000000000000000000000000000000000000000000000000000004
4000000000000000000000000000000000000000000000000000000000000000000004
4000000000000000000000000000000000000000000000000000000000000000000004
4000000000000000000000000000000000000000000000000000000000000000000004
4000000000000000000000000000000000000000000000000000000000000000000004
4000000000000000000000000000000000000000000000000000000000000000000004
4000000000000000000000000000000000000000000000000000000000000000000004
4000000000000000000000000000000000000000000000000000000000000000000004
4000000000000000000000000000000000000000000000000000000000000000000004
4000000000000000000000000000000000000000000000000000000000000000000004
4000000000000000000000000000000000000000000000000000000000000000000004
4000000000000000000000000000000000000000000000000000000000000000000004
4000000000000000000000000000000000000000000000000000000000000000000004
5222222222222222222222222222222222222222222222222222222222222222222226